{
  "map": [
    [1,1,1,1,1,1,1,1,1,1],
    [1,0,0,0,0,0,0,0,0,1],
    [1,0,0,0,0,0,0,0,0,1],
    [1,0,0,0,0,0,0,0,2,1],
    [1,0,0,0,0,0,0,0,0,1],
    [1,0,0,0,0,0,0,0,0,1],
    [1,1,1,1,1,1,1,1,1,1]
  ],
  "transfer": {
    "2": {
      "targetMap": "./data/maps/startMap.json",
      "spawnX": 1,
      "spawnY": 1
    }
  }
}
