{
  "map": [
    [1,1,1,1,1,1,1,1,1,1,1,1,1,1,1,1,1,1,1,1,1],
    [1,0,0,0,0,0,0,0,0,0,0,0,0,1,0,1,0,0,0,0,1],
    [1,0,0,1,1,1,1,0,0,0,0,0,0,1,0,1,0,1,1,0,1],
    [1,0,0,1,1,1,1,0,0,0,0,0,0,1,0,0,0,1,1,0,1],
    [1,0,0,1,1,1,1,0,0,0,0,1,1,1,0,1,0,0,0,0,1],
    [1,0,0,0,2,0,0,0,0,0,0,0,0,0,0,1,1,1,0,0,1],
    [1,0,0,0,0,0,0,0,0,0,0,0,0,0,0,0,0,0,0,0,1],
    [1,0,0,0,0,0,0,0,0,0,0,0,0,0,0,0,0,0,1,0,1],
    [1,0,0,0,0,0,0,0,0,0,0,0,0,0,0,0,0,0,1,0,1],
    [1,0,0,0,0,0,0,0,0,1,0,1,0,0,0,0,1,1,1,1,1],
    [1,0,0,0,0,0,0,0,0,0,0,10,0,0,10,0,1,0,0,0,1],
    [1,0,0,0,0,0,0,0,0,1,0,1,0,0,0,0,1,0,1,0,1],
    [1,0,0,0,0,0,0,0,0,0,0,0,0,0,0,0,1,0,1,0,1],
    [1,0,0,0,0,0,0,0,0,0,0,0,0,0,0,0,1,0,1,0,1],
    [1,3,3,0,0,0,0,0,0,0,0,0,0,0,0,1,1,0,1,1,1],
    [1,3,3,3,3,0,0,0,0,0,0,0,0,0,0,0,0,0,0,0,1],
    [1,3,3,3,3,0,0,0,0,0,0,0,0,0,0,1,1,1,1,0,1],
    [1,3,3,3,3,3,3,3,0,0,0,0,0,0,1,0,0,0,0,0,1],
    [1,3,3,3,3,3,3,3,3,0,0,0,0,0,1,0,1,0,1,0,1],
    [1,3,3,3,3,3,3,3,3,3,0,0,0,0,1,0,0,0,0,0,1],
    [1,1,1,1,1,1,1,1,1,1,1,1,1,1,1,1,1,1,1,1,1]
  ],
  "transfer": {
    "2": {
      "targetMap": "./data/maps/map2.json",
      "spawnX": 1,
      "spawnY": 1
    }
  },
  "npcs": [
    {
      "x": 11 ,
      "y": 10,
      "name": "Wirt",
      "dialog": [
        "Willkommen in meiner Taverne!",
        "Hast du Hunger oder Durst?"
      ]
    },
    {
      "x": 14,
      "y": 10,
      "name": "Händler",
      "dialog": [
        "Hallo Abenteurer!",
        "Bei mir kannst du Waren aus aller Welt kaufen.",
        "Möchtest du dir mein Sortiment ansehen?",
        "[Shop folgt]"
      ]
    }
  ]
}
